11111111
1001
1E01111111111111111111111111

1111