111111111111
1W0000000001
111000000001
100000000001
111000111101
100000000101
101110011101
101010000001
111111111111