1111111111
1000E00001
1000100001
1001 10001
1000100001
1000000001
1111111111