1111  1111
11 1111E01
1111111111

