  111111 111
111W0001 101
111000011101
  1000000001
111000111101111111111111
1000001  100000000000001
101110111101000000000001
101 10000001111111111111
111 11111110