NO ./path_to_the_north_texture
SO ./path_to_the_south_texture
WE ./path_to_the_west_texture
EA ./path_to_the_east_texture
F 255,100,0
C 255,30,0
111111111111111111111111111111
100000000000011100000000000001
100000000000001000000000000001
100000000000000000000000000001
111111000000000000000000000001
100001000000000000000000000001
100000000000000000000000001111
100000000000000000000000000001
100000000000000000000000000001
100000000000000000100000000001
100010000000000001000000000001
100001000000000010000000000001
100000100000000100000000000001
100000010000001000000000000001
100000001000010000000000000001
100000000100100000000000000001
10000000001100000000000N000001
100000000100000000000000000001
100000001000000000000000000001
100000010000000000000000000001
100000100000000000000000000001
100000100000000000000011100001
10000010000000000000001 100001
100000100000000000000011100001
100000100000000000000000000001
111111111111111111111111111111

