11111111
1S000001
10000001
10000001
10000001
10000001
11111111